#######s#######
#             #
#    m        #
#             #
#       m     #
#             #
######e########
